1111111111111
1X000C00 0C01
10C0011111001
10X11E0000001
1111111111111