1111111111111
10010PC000C01
10C0011111X11
100011E000E0111
1111111111111