1111111111111111111111111111111111111111111111111111111111111
1X000C0000C01000000000000000000000100000000000000000000000001
10C0011111000000000000000000000000000000000000000000000000001
10X11E00P0000000000000000000000000000000C00000000X000000000X1
1111111111111111111111111111111111111111111111111111111111111